888888888
800000008
800000008
800008888
800000008
900000008
888888888
