8888888888
8008000008
8008000008
8008008008
8008008008
8000008008
8000008008
8888888008
8000000008
8000000008
8898888888
