888888988888888
800000000800008
800000000800008
800800000880008
800888800000088
800000800000008
800000800000008
888888800000888
800000000000088
800000000000008
800000888880008
800000000800008
800800000800008
800800000800008
888888888888888
