8888888888888888
8000000000000008
8000000000000008
8888888888888008
8000000000008008
8000000000008008
8008888888008008
8008000008008008
8008000008008008
8008008908008008
8008008888008008
8008000000008008
8008000000008008
8008888888888008
8000000000000008
8000000000000008
8888888888888888